@@@@@@@@@@@@@@@@@@@@@@@@@@@@@@@@@@@@@@@@
@@@@@@@@@@@@@@@@@@@@@@@@@@@@@@@@@@@@@@@@
@@@@@@@@@@@@@@@@@@@@@@@@@@@##@@@@@@@@@@@
@@@@@@@@#####@@@@@@@@@@@###@##@@@@@@@@@@
@@@@@@##@@@@@##@@@@@@@@#@@@@@@###@@@@@@@
@@@@@@5@@@@@@@##@@@@@@#@@@@@@@@@##@@@@@@
@@@@@@#@@@@@@@@@#@@@@#@@@@@@@@@@@#@@@@@@
@@@@@@#@@@@@@@@@@#@@@#@@@@@@@@@@@@#@@@@@
@@@@@@#@@@@@@@@@@##@#@@@@@@@@@@@@@#@@@@@
@@@@@@#@@@@@@@@@@@#@#@@@@@@@@@@@@@@#@@@@
@@@@@@#@@@@@@@@@@@@##@@@@@@@@@@@@@@#@@@@
@@@@@@#@@@@@@@@@@@@#@@@@@@@@@@@@@@@#@@@@
@@@@@@##@@@@@@@@@@@@@@@@@@@@@@@@@@@#@@@@
@@@@@@@#@@@@@@@@@@@@@@@@@@@@@@@@@@@#@@@@
@@@@@@@##@@@@@@@@@@@@@@@@@@@@@@@@@@#@@@@
@@@@@@@@##@@@@@@@@@@@@@@@@@@@@@@@@@#@@@@
@@@@@@@@@#@@@@@@@1@@@@@@@@@@@@@@@@##@@@@
@@@@@@@@@#@@@@@@@@@@@@@@@@@@@@@@@@#@@@@@
@@@@@@@@@@#@@@@@@@@@@@@@@@@@@@@@@##@@@@@
@@@@@@@@@@##@@@@@@@@@@@@@@@@@@@@@#@@@@@@
@@@@@@@@@@@#@@@@@@@@@@@@@@@@@@@##@@@@@@@
@@@@@@@@@@@@#@@@@@@@@@@@@@@@@@@#@@@@@@@@
@@@@@@@@@@@@##@@@@@@@@@@@@@@@##@@@@@@@@@
@@@@@@@@@@@@@##@@@@@@@@@@@@@#@@@@@@@@@@@
@@@@@@@@@@@@@@##@@@@@@@@@@##@@@@@@@@@@@@
@@@@@@@@@@@@@@@##@@@@@@@##@@@@@@@@@@@@@@
@@@@@@@@@@@@@@@@@#@@@@@##@@@@@@@@@@@@@@@
@@@@@@@@@@@@@@@@@@######@@@@@@@@@@@@@@@@
@@@@@@@@@@@@@@@@@@@@@@@@@@@@@@@@@@@@@@@@
@@@@@@@@@@@@@@@@@@@@@@@@@@@@@@@@@@@@@@@@
